000000000000000000
0c0100100100100100
001001001001001001
010101010110101001
000000000000000000
100100010000100101
201020022100010000
100010010010000030
111111111111111111
3stage