c00000000002000000
100002000001000000
000001001000011000
002000000000000010
000000000010000100
001000000100001000
000000101020100000
002010000010000300
001000000000000110
4stage