0c0000000000000200
010201001000010100
000000000011200000
000000020000010000
000000000100100000
000010000001000000
020102001000000103
010000100010010010
000000000000100000
5stage