000000000000000000
000200001000000000
000100100010000002
000000000001001201
200000000100011102
130000001001001201
0c0010010000001102
010100000000001111
000000000000000000
6stage