000000002000000000
000000001000000020
c00000100000101010
100010000000000000
001000200000000000
000000100000000000
002000000000000000
001000002000000030
000010101001010010
7stage