000020000000000200
000000001000100000
001000100000000000
000000001000000003
c00000000001000000
000000000002010000
000010010001000000
001000000000000000
100000000000000000
8stage