200000000000000000
111101100100200112
001012210100101021
001010010001101001
000000000100100001
201011110000101111
1c1010010102100001
111010010011001001
000000000000000003
ENDstage