000c00000000000000
000100100100100100
001001001001001001
010101010110101001
000000000000000000
100100010000100101
101010000100010000
200020020020000030
111111111111111111
2stage